{
  "size": {
            "x":10,
            "y":10
          },
  "floor_0":[
              [0,0,0,0,0,0,0,0,0,0],
              [0,0,0,0,0,0,0,0,0,0],
              [0,0,0,0,0,0,0,0,0,0],
              [0,0,0,0,1,0,0,0,0,0],
              [0,0,0,0,1,1,0,0,0,0],
              [0,0,0,0,1,1,0,0,0,0],
              [0,0,0,0,0,1,0,0,0,0],
              [0,0,0,0,0,0,0,0,0,0],
              [0,0,0,0,0,0,0,0,0,0],
              [0,0,0,0,0,0,0,0,0,0]
            ],
  "floor_1":[
              [1,0,0,0,0,0,0,0,0,0],
              [1,0,0,0,0,0,0,0,0,0],
              [1,0,0,0,0,0,0,0,0,0],
              [1,0,0,0,2,0,0,0,0,0],
              [1,0,0,0,2,0,0,0,0,0],
              [1,0,0,0,2,0,0,0,0,0],
              [1,0,0,0,0,0,0,0,0,0],
              [1,0,0,0,0,0,0,0,0,0],
              [1,0,0,0,0,0,0,0,0,0],
              [1,1,0,0,0,0,0,0,0,0]
            ]
}
